10001,10001,10001,10001,10001,10001,10001,10001,10001,10001,10001,10001,10001,10001,10001,10001,10001,10001,10001,10001,10001,10001,10001,10001,10001,10001,10001,10001,10001,10001,10001,10001,10001,10001,10001,10001,10001,10001,10001,10001,10001
10001,10003,10009,10009,10001,10009,10009,10009,10009,10009,10009,10009,10009,10009,10009,10009,10009,10009,10009,10009,10001,10009,10009,10009,10001,10009,10009,10009,10001,10009,10009,10009,10009,10009,10009,10009,10009,10009,10009,10009,10001
10001,10001,10001,10009,10001,10009,10001,10001,10001,10001,10001,10001,10001,10001,10001,10001,10001,10001,10001,10009,10001,10009,10001,10009,10001,10009,10001,10009,10001,10001,10001,10009,10001,10001,10001,10001,10001,10001,10001,10009,10001
10001,10009,10001,10009,10001,10009,10001,10009,10009,10009,10009,10009,10009,10009,10001,10009,10009,10009,10009,20010,10001,10009,10001,10009,10009,10009,10001,10009,10009,10009,10009,10009,10001,20030,10009,10009,10009,10009,10001,10009,10001
10001,10009,10001,10009,10001,10009,10001,10009,10001,10001,10001,10009,10001,10001,10001,10009,10001,10001,10001,10001,10001,10009,10001,10001,10001,10001,10001,10001,10001,10001,10001,10009,10001,10001,10001,10009,10001,10009,10001,10009,10001
10001,10009,10009,10009,10001,10005,10001,10009,10001,10009,10009,10009,10001,10009,10009,10009,10001,10009,10009,10005,10009,10009,10001,10009,10009,10009,10009,10009,10009,10009,10009,10009,10009,10009,10001,10009,10001,10009,10001,10009,10001
10001,10009,10001,10001,10001,10009,10001,10009,10001,10001,10001,10009,10001,10009,10001,10001,10001,10009,10001,10001,10001,10001,10001,10001,10001,10009,10001,10001,10001,10001,10001,10001,10001,10009,10001,10009,10001,10001,10001,10009,10001
10001,10009,10001,20020,10009,10009,10001,10009,10009,10009,10001,10009,10001,10009,10009,10009,10001,10009,10009,10009,10009,10009,10009,10009,10009,10009,10001,10009,10001,10009,10009,10009,10009,10009,10001,10009,10001,10009,10009,10009,10001
10001,10009,10001,10001,10001,10009,10001,10009,10001,10009,10001,10009,10001,10001,10001,10009,10001,10009,10001,10009,10001,10009,10001,10009,10001,10001,10001,10009,10001,10009,10001,10001,10001,10001,10001,10009,10001,10009,10001,10001,10001
10001,10009,10009,10009,10009,10009,10001,10009,10001,10009,10001,10009,10001,10009,10009,10009,10001,10009,10001,10009,10001,20010,10001,10009,10009,10009,10001,10005,10009,10009,10009,10009,10009,10009,10009,10009,10001,10009,10009,10009,10001
10001,10001,10001,10001,10001,10009,10001,10001,10001,10009,10001,10001,10001,10009,10001,10001,10001,10009,10001,10009,10001,10001,10001,10001,10001,10009,10001,10001,10001,10009,10001,10001,10001,10001,10001,10001,10001,10001,10001,10009,10001
10001,10009,10009,10009,10009,10009,10009,10009,10009,10009,10001,10009,10009,10009,10001,10009,10001,10009,10001,10009,10009,10009,10009,10009,10001,10009,10009,10009,10001,10009,10009,10009,10009,10009,10009,10009,10001,10009,10009,10009,10001
10001,10009,10001,10001,10001,10001,10001,10009,10001,10001,10001,10009,10001,10001,10001,10009,10001,10009,10001,10001,10001,10001,10001,10009,10001,10009,10001,10009,10001,10009,10001,10001,10001,10001,10001,10009,10001,10009,10001,10001,10001
10001,10009,10001,10009,10009,10009,10001,10009,10009,10009,10001,10009,10001,10009,10009,10009,10009,10009,10009,10009,10001,10009,10009,20020,10001,10009,10001,10009,10001,10009,10001,10009,10009,10009,10001,10009,10009,10009,10001,10009,10001
10001,10001,10001,10009,10001,10009,10001,10001,10001,10009,10001,10009,10001,10001,10001,10009,10001,10001,10001,10001,10001,10009,10001,10001,10001,10009,10001,10009,10001,10009,10001,10009,10001,10009,10001,10001,10001,10001,10001,10009,10001
10001,10009,10009,10009,10001,10009,10009,10009,10001,10009,10001,10009,10009,10009,10009,10009,10009,10009,10001,10009,10009,10009,10001,10009,10009,10009,10001,10009,10001,10009,10001,10009,10001,10009,10009,10009,10009,10009,10009,10009,10001
10001,10009,10001,10001,10001,10001,10001,10009,10001,10009,10001,10009,10001,10001,10001,10001,10001,10001,10001,10009,10001,10001,10001,10001,10001,10009,10001,10009,10001,10009,10001,10009,10001,10001,10001,10001,10001,10001,10001,10009,10001
10001,10009,10001,10009,10009,10009,10001,10009,10009,10009,10009,10009,10001,10009,10009,10009,10009,10009,10009,10009,10001,10009,10009,10009,10001,10009,10001,10009,10001,10009,10001,10009,10009,10009,10009,10009,10001,10009,10009,10009,10001
10001,10009,10001,10009,10001,10009,10001,10001,10001,10001,10001,10009,10001,10001,10001,10001,10001,10001,10001,10001,10001,10009,10001,10009,10001,10001,10001,10001,10001,10009,10001,10001,10001,10001,10009,10009,10001,10001,10001,10009,10001
10001,10009,10001,10009,10009,10009,10001,10009,10009,10009,10001,10009,10001,10009,10009,10009,10001,10009,10009,10009,10009,10009,10001,10009,10009,20010,10009,10009,10009,10009,10009,10009,10009,10009,10001,10009,10009,10009,10001,10009,10001
10001,10009,10001,10009,10001,10001,10001,10009,10001,10001,10001,10009,10001,10009,10001,10009,10001,10009,10001,10001,10001,10009,10001,10001,10001,10001,10001,10009,10001,10001,10001,10001,10001,10009,10001,10009,10001,10009,10001,10009,10001
10001,10009,10001,10009,10009,10009,10009,10009,10009,10009,10009,10009,10001,10009,10001,10009,10009,10005,10009,10009,10001,10009,10009,10009,10009,10009,10001,10009,10001,10009,10009,10009,10001,10009,10001,10009,10001,10009,10001,10009,10001
10001,10009,10001,10009,10001,10001,10001,10001,10001,10001,10001,10001,10001,10001,10001,10001,10001,10001,10001,10009,10001,10001,10001,10001,10001,10009,10001,10009,10001,10009,10001,10001,10001,10001,10001,10001,10001,10009,10001,10009,10001
10001,10009,10001,10009,10009,10009,10001,10009,10009,10009,10001,10009,10009,10009,10009,10009,10001,10009,10009,10009,10009,10009,10009,20020,10001,10009,10001,10009,10001,10009,10001,10005,10009,10009,10009,10009,10009,10009,10009,10009,10001
10001,10009,10001,10001,10001,10009,10001,10009,10001,10009,10001,10001,10001,10001,10001,10009,10001,10001,10001,10001,10001,10001,10001,10001,10001,10009,10001,10009,10001,10009,10001,10001,10001,10009,10001,10001,10001,10001,10001,10009,10001
10001,10009,10001,10009,10009,10009,10001,10009,10001,10009,10009,10009,10001,20010,10001,10009,10001,10009,10009,10009,10009,10009,10009,10009,10009,10009,10001,10009,10001,10009,10009,10009,10009,10009,10001,10009,10009,10009,10001,20020,10001
10001,10001,10001,10009,10001,10001,10001,10009,10001,10001,10001,10009,10001,10009,10001,10009,10001,10009,10001,10001,10001,10001,10001,10009,10001,10001,10001,10001,10001,10001,10001,10001,10001,10001,10009,10009,10001,10001,10001,10001,10001
10001,20020,10009,10009,10001,10009,10009,10009,10001,10009,10009,10009,10001,10009,10001,10009,10009,10009,10001,10009,10009,10009,10009,10009,10009,10009,10009,10009,10009,10009,10009,10009,10009,10009,10009,10009,10001,10009,10009,10009,10001
10001,10009,10001,10001,10001,10009,10001,10001,10001,10009,10001,10001,10001,10009,10001,10009,10001,10001,10001,10009,10001,10001,10001,10001,10001,10009,10001,10009,10001,10009,10001,10001,10001,10001,10001,10001,10001,10009,10001,10001,10001
10001,10009,10009,10009,10009,10009,10009,10009,10001,10009,10001,10009,10009,10009,10009,10009,10009,10009,10001,10009,10001,10009,10009,10009,10009,10009,10001,10005,10001,10009,10009,10009,10009,10009,10009,10009,10009,10009,10001,10009,10001
10001,10009,10001,10001,10001,10001,10001,10001,10001,10009,10001,10009,10001,10001,10001,10001,10001,10001,10001,10009,10001,10009,10001,10001,10001,10001,10001,10009,10001,10001,10001,10001,10001,10001,10001,10001,10001,10001,10001,10009,10001
10001,10009,10001,10009,10009,10009,10001,10009,10009,10009,10001,10009,10009,10009,10009,10009,10009,10009,10001,10009,10009,10009,10001,10009,10009,10009,10009,10009,10009,10009,10009,20010,10009,10009,10009,10009,10001,10009,10009,10009,10001
10001,10009,10001,10001,10001,10009,10001,10009,10001,10001,10001,10001,10001,10001,10001,10001,10001,10009,10001,10009,10001,10001,10001,10009,10001,10001,10001,10001,10001,10001,10001,10009,10001,10001,10001,10009,10001,10009,10001,10009,10001
10001,10009,10009,10009,10009,10009,10009,10009,10009,10009,10009,10009,10009,10009,10009,10009,10009,10009,10001,10009,10001,10009,10009,10009,10001,10009,10009,10009,10009,10009,10001,10009,10001,10009,10009,10009,10001,10009,10001,10009,10001
10001,10001,10001,10001,10001,10009,10001,10001,10001,10001,10001,10001,10001,10009,10001,10001,10001,10001,10001,10009,10001,10009,10001,10001,10001,10009,10001,10001,10001,10009,10001,10009,10001,10009,10001,10001,10001,10009,10001,10001,10001
10001,10009,10001,10009,10009,10009,10001,10009,10009,10009,10009,10009,10001,10009,10001,10009,10009,10009,10001,10009,10001,10009,10009,10009,10001,10009,10001,10009,10009,10009,10001,10009,10001,10009,10001,10009,10009,10009,10009,10009,10001
10001,10009,10001,10009,10001,10001,10001,10001,10001,10009,10001,10009,10001,10009,10001,10009,10001,10001,10001,10001,10001,10009,10009,10009,10001,10009,10001,10009,10001,10001,10001,10009,10001,10009,10001,10001,10001,10001,10001,10009,10001
10001,10009,10009,10009,10001,10009,10009,10009,10001,10009,10001,10009,10001,10009,10009,10009,10001,10009,10009,10009,10009,10009,10009,10009,10001,10009,10001,10009,10009,10009,10001,10009,10001,10009,10001,10009,10009,10009,10009,10009,10001
10001,10009,10001,10001,10001,10009,10001,10009,10001,10001,10001,10009,10001,10001,10001,10001,10001,10001,10001,10001,10001,10001,10001,10001,10001,10001,10001,10001,10001,10009,10001,10009,10001,10009,10001,10009,10001,10001,10001,10009,10001
10001,10009,10009,10009,10009,10009,10001,10009,10009,10009,10009,10009,10009,10005,10009,10009,10009,10009,10009,10009,10009,20030,10001,10009,10009,10009,10009,10009,10009,10009,10009,10009,10001,10009,10009,10009,10001,10009,10009,10007,10001
10001,10001,10001,10001,10001,10001,10001,10001,10001,10001,10001,10001,10001,10001,10001,10001,10001,10001,10001,10001,10001,10001,10001,10001,10001,10001,10001,10001,10001,10001,10001,10001,10001,10001,10001,10001,10001,10001,10001,10001,10001
