10001,10001,10001,10001,10001,10001,10001,10001,10001,10001,10001,10001,10001,10001,10001,10001,10001,10001,10001,10001,10001,10001,10001,10001,10001,10001,10001,10001,10001,10001,10001,10001,10001,10001,10001,10001,10001,10001,10001,10001,10001
10001,10003,10009,10009,10001,10009,10009,10009,10009,10009,10009,10009,10009,10009,10009,10009,10009,50002,10009,10009,10001,10009,10009,10009,10001,10009,10009,10009,10001,10009,10009,10009,10009,10009,10009,10009,10009,10009,10009,10009,10001
10001,10001,10001,10009,10001,10009,10001,10001,10001,10001,10001,10001,10001,10001,10001,10001,10001,10001,10001,10009,10001,10009,10001,10009,10001,10009,10001,10009,10001,10001,10001,10009,10001,10001,10001,10001,10001,10001,10001,10009,10001
10001,10009,10001,10009,10001,10009,10001,10009,10009,10009,10009,10009,10009,10009,10001,10009,10009,10009,10009,20010,10001,10009,10001,10009,10009,10009,10001,10009,10009,10009,10009,10009,10001,20030,10009,10009,10009,10009,10001,10009,10001
10001,10009,10001,10009,10001,10009,10001,10009,10001,10001,10001,10009,10001,10001,10001,10009,10001,10001,10001,10001,10001,10009,10001,10001,10001,10001,10001,10001,10001,10001,10001,10009,10001,10001,10001,10009,10001,10009,10001,10009,10001
10001,10009,10009,30017,10001,10005,10001,10009,10001,10009,10009,10009,10001,10009,10009,10009,10001,10009,10009,10005,10009,10009,10001,30016,10009,10009,10009,50001,10009,10009,10009,10009,10009,50001,10001,10009,10001,20023,10001,10009,10001
10001,10009,10001,10001,10001,10009,10001,10009,10001,10001,10001,10009,10001,10009,10001,10001,10001,10009,10001,10001,10001,10001,10001,10001,10001,10009,10001,10001,10001,10001,10001,10001,10001,10009,10001,10009,10001,10001,10001,10009,10001
10001,10009,10001,20020,10009,10009,10001,10009,10009,10009,10001,10009,10001,10009,10009,10009,10001,10009,10009,10009,10009,10009,10009,10009,10009,10009,10001,10009,10001,10009,10009,10009,10009,10009,10001,10009,10001,10009,10009,10009,10001
10001,10009,10001,10001,10001,10009,10001,10009,10001,10009,10001,10009,10001,10001,10001,10009,10001,10009,10001,10009,10001,10009,10001,10009,10001,10001,10001,10009,10001,10009,10001,10001,10001,10001,10001,10009,10001,10009,10001,10001,10001
10001,10009,10009,10009,10009,10009,10001,20022,10001,10009,10001,30016,10001,10009,10009,10009,10001,10009,10001,10009,10001,20010,10001,10009,10009,10009,10001,10005,10009,10009,10009,10009,10009,10009,10009,10009,10001,10009,10009,10009,10001
10001,10001,10001,10001,10001,10009,10001,10001,10001,10009,10001,10001,10001,10009,10001,10001,10001,10009,10001,10009,10001,10001,10001,10001,10001,10009,10001,10001,10001,10009,10001,10001,10001,10001,10001,10001,10001,10001,10001,10009,10001
10001,10009,10009,10009,10009,10009,10009,10009,10009,10009,10001,50001,10009,10009,10001,10009,10001,10009,10001,10009,10009,10009,10009,10009,10001,10009,10009,10009,10001,10009,10009,50002,10009,10009,10009,10009,10001,10009,10009,10009,10001
10001,10009,10001,10001,10001,10001,10001,10009,10001,10001,10001,10009,10001,10001,10001,10009,10001,10009,10001,10001,10001,10001,10001,10009,10001,10009,10001,10009,10001,10009,10001,10001,10001,10001,10001,10009,10001,10009,10001,10001,10001
10001,10009,10001,10009,10009,10009,10001,10009,10009,10009,10001,10009,10001,10009,10009,10009,10009,10009,10009,20022,10001,10009,10009,20020,10001,10009,10001,10009,10001,10009,10001,10009,10009,10009,10001,10009,10009,10009,10001,10009,10001
10001,10001,10001,10009,10001,10009,10001,10001,10001,10009,10001,10009,10001,10001,10001,10009,10001,10001,10001,10001,10001,10009,10001,10001,10001,10009,10001,10009,10001,10009,10001,10009,10001,10009,10001,10001,10001,10001,10001,10009,10001
10001,10009,10009,10009,10001,10009,10009,10009,10001,10009,10001,10005,10009,10009,10009,10009,10009,10009,10001,10009,10009,10009,10001,10009,10009,10009,10001,10009,10001,10009,10001,10009,10001,10009,10009,10009,10009,10009,10009,10009,10001
10001,10009,10001,10001,10001,10001,10001,10009,10001,10009,10001,10009,10001,10001,10001,10001,10001,10001,10001,10009,10001,10001,10001,10001,10001,10009,10001,10009,10001,10009,10001,10009,10001,10001,10001,10001,10001,10001,10001,10009,10001
10001,10009,10001,30016,10009,10009,10001,10009,10009,10009,10009,10009,10001,10009,10009,10009,10009,10009,10009,10009,10001,10009,10009,10009,10001,10009,10001,10009,10001,10009,10001,30016,10009,10009,10009,10009,10001,10009,10009,10009,10001
10001,10009,10001,10009,10001,10009,10001,10001,10001,10001,10001,10009,10001,10001,10001,10001,10001,10001,10001,10001,10001,10009,10001,10009,10001,10001,10001,10001,10001,10009,10001,10001,10001,10001,10009,10009,10001,10001,10001,10009,10001
10001,10009,10001,10009,10009,10009,10001,10009,10009,10009,10001,10009,10001,10009,10009,10009,10001,10009,10009,10009,10009,30016,10001,10009,10009,20010,10009,10009,10009,10009,10009,10009,10009,20023,10001,10009,10009,10009,10001,10009,10001
10001,10009,10001,10009,10001,10001,10001,10009,10001,10001,10001,10009,10001,10009,10001,10009,10001,10009,10001,10001,10001,10009,10001,10001,10001,10001,10001,10009,10001,10001,10001,10001,10001,10009,10001,10009,10001,10009,10001,10009,10001
10001,10009,10001,10009,10009,10009,10009,10009,10009,10009,10009,10009,10001,10009,10001,10009,10009,10005,10009,10009,10001,10009,10009,10009,10009,10009,10001,10009,10001,10009,10009,50001,10001,10009,10001,20024,10001,10009,10001,10009,10001
10001,10009,10001,10009,10001,10001,10001,10001,10001,10001,10001,10001,10001,10001,10001,10001,10001,10001,10001,10009,10001,10001,10001,10001,10001,10009,10001,10009,10001,10009,10001,10001,10001,10001,10001,10001,10001,10009,10001,10009,10001
10001,10009,10001,10009,10009,10009,10001,10009,10009,10009,10001,10009,10009,10001,10009,10009,10001,10009,10009,10009,10009,10009,10009,20020,10001,10009,10001,10009,10001,10009,10001,10005,10009,10009,10009,10009,10009,10009,10009,10009,10001
10001,10009,10001,10001,10001,10009,10001,10009,10001,10009,10001,10001,10001,10001,10001,10009,10001,10001,10001,10001,10001,10001,10001,10001,10001,10009,10001,10009,10001,10009,10001,10001,10001,10009,10001,10001,10001,10001,10001,10009,10001
10001,20026,10001,10009,10009,10009,10001,10009,10001,10009,10009,10009,10001,10001,10001,10009,10001,10009,10009,10009,10009,10009,10009,10009,10009,10009,10001,10009,10001,10009,10009,50001,10009,10009,10001,10009,10009,10009,10001,20020,10001
10001,10001,10001,10009,10001,10001,10001,10009,10001,10001,10001,10009,10001,10001,10001,10009,10001,10009,10001,10001,10001,10001,10001,10009,10001,10001,10001,10001,10001,10001,10001,10001,10001,10001,10009,10009,10001,10001,10001,10001,10001
10001,20020,10009,10009,10001,10009,10009,10009,10001,10009,10009,10009,10001,10001,10001,10009,10009,10009,10001,10009,10009,10009,10009,10009,10009,10009,10009,10009,10009,10009,10009,10009,10009,10009,10009,10009,10001,10009,10009,10009,10001
10001,10009,10001,10001,10001,10009,10001,10001,10001,10009,10001,10001,10001,10001,10001,10009,10001,10001,10001,10009,10001,10001,10001,10001,10001,10009,10001,10009,10001,10009,10001,10001,10001,10001,10001,10001,10001,10009,10001,10001,10001
10001,10009,10009,10009,10009,10009,10009,10009,10001,10009,10001,10009,10009,10001,10009,10009,10009,10009,10001,10009,10001,10009,10009,10009,10009,10009,10001,10005,10001,10009,10009,10009,10009,10009,10009,10009,10009,10009,10001,10009,10001
10001,10009,10001,10001,10001,10001,10001,10001,10001,10009,10001,10009,10001,10001,10001,10001,10001,10001,10001,10009,10001,10009,10001,10001,10001,10001,10001,10009,10001,10001,10001,10001,10001,10001,10001,10001,10001,10001,10001,10009,10001
10001,10009,10001,10005,10009,10009,10001,10009,10009,10009,10001,10009,10009,10001,10009,10009,10009,10009,10001,10009,10009,10009,10001,10009,10009,10009,10009,10009,10009,10009,10009,20010,10009,10009,10009,10009,10001,10009,10009,10009,10001
10001,10009,10001,10001,10001,10009,10001,10009,10001,10001,10001,10001,10001,10001,10001,10001,10001,10009,10001,10009,10001,10001,10001,10009,10001,10001,10001,10001,10001,10001,10001,10009,10001,10001,10001,10009,10001,10009,10001,10009,10001
10001,10009,10009,50001,10009,10009,10009,10009,10009,10009,10009,10009,10009,30016,10009,10009,10009,10009,10001,10009,10001,10009,10009,10009,10001,10009,10009,10009,10009,10009,10001,10009,10001,10009,10009,10009,10001,10009,10001,10009,10001
10001,10001,10001,10001,10001,10009,10001,10001,10001,10001,10001,10001,10001,10001,10001,10001,10001,10001,10001,10009,10001,10009,10001,10001,10001,10009,10001,10001,10001,10009,10001,10009,10001,10009,10001,10001,10001,10009,10001,10001,10001
10001,10009,10001,10009,10009,10009,10001,10009,10009,10009,10009,10009,10001,10001,10001,10009,10009,20024,10001,10009,10001,10009,10009,10009,10001,10009,10001,10009,10009,10009,10001,10009,10001,10009,10001,10015,10009,10009,10009,10009,10001
10001,10009,10001,10009,10001,10001,10001,10001,10001,10009,10001,10009,10001,10001,10001,10009,10001,10001,10001,10001,10001,10009,10009,10009,10001,10009,10001,10009,10001,10001,10001,10009,10001,10009,10001,10001,10001,10001,10001,10009,10001
10001,10009,10009,10009,10001,10009,10009,10009,10001,10009,10001,10009,10001,10001,10009,10009,10001,20026,10009,10009,10009,10009,10009,30018,10001,10009,10001,10009,10009,10009,10001,10009,10001,10009,10001,10009,10009,10009,10009,50005,10001
10001,10009,10001,10001,10001,10009,10001,10009,10001,10001,10001,10009,10001,10001,10001,10001,10001,10001,10001,10001,10001,10001,10001,10001,10001,10001,10001,10001,10001,10009,10001,10009,10001,10009,10001,10009,10001,10001,10001,10009,10001
10001,50002,10009,10009,10009,10009,10001,10009,10009,10009,10009,10009,10009,10005,10009,10009,10009,10009,50001,10009,10009,20030,10001,20026,10009,10009,10009,10009,10009,10009,10009,50002,10001,10009,10009,10009,10001,10009,10009,10007,10001
10001,10001,10001,10001,10001,10001,10001,10001,10001,10001,10001,10001,10001,10001,10001,10001,10001,10001,10001,10001,10001,10001,10001,10001,10001,10001,10001,10001,10001,10001,10001,10001,10001,10001,10001,10001,10001,10001,10001,10001,10001